#..............................................................................#
#..............................................................................#
#..............................................................................#
#..............................................................................#
############################################################....#....###########
#.......#......................................................#...............#
#.......#.....................................................#................#
#.......#......################################################................#
#...#####......#...............................................................#
#..............#.........#.##############.......################...#...#.......#
#..............#.........#..............#..................#.......#...#.#######
#######.....##########...#...........................#.....#.......#...#.......#
#........................#..............#########....#.....#.......#...#.#####.#
#.................#######################............#.....#.......#...#.#.....#
#.......................................#.......######.....#########...#.#.#####
#.......................................#............#...................#.#...#
#...............#.....#.#############...#............#...................#.#.#.#
#...............#.....#.............#...#........##..############........#...#.#
#...............#.....#.............#...#........#.......#..........##########.#
#.###############.....####.########.#...#........#..###..#....#.....#..........#
#...............#.............#.........#........#.......#....#.....#..........#
#...............########......#..############....#..###..#....#.....#..........#
#.............................#..................#..................#..........#
################################################################################