#..............................................................................#
#..............................................................................#
#..............................................................................#
#................................................................#.............#
#...............................................................#..............#
#..............................................................#..............#
#.............................................................#................#
#..............################################################................#
#..............#...............................................................#
#..............#...............................................................#
#..............#...............................................................#
#..............#######...............................#.........................#
#....................................................#.........................#
#....................................................#.........................#
#...............................................######.........................#
#....................................................#.........................#
#...............#.....#.#############................#.........................#
#...............#.....#.............#................############..............#
#...............#.....#.............#..........................................#
#...............#.....####.########.#..........................................#
#...............#.............#................................................#
#...............########......#................................................#
#.............................#................................................#
################################################################################